0 0 0 0 0 0 0 0 0 0 0 0 0 0 0 0 0 0 0 0 0 0 0 0 0 0 0 0 0 0 0 673 673 674 665 653 0 0 673 674 657 0 0 0 0 0 0 0 0 0 0 0 0 681 673 674 728 0 0 0
0 0 0 0 0 0 0 0 0 0 0 0 0 0 0 0 0 0 0 0 0 0 0 0 0 0 0 0 0 0 0 681 673 674 673 657 0 0 681 682 665 653 0 0 0 0 0 0 0 652 666 653 0 0 681 682 672 0 705 706
0 0 0 0 0 0 0 0 0 0 0 0 0 0 0 0 0 0 0 0 0 0 0 0 0 0 0 0 0 0 0 0 681 682 673 665 653 0 0 0 673 665 653 0 0 0 0 0 652 667 713 665 666 653 0 0 680 0 673 674
0 0 0 0 0 0 0 0 1137 1137 1137 1137 1137 1137 1137 0 0 0 0 0 0 0 0 0 0 0 0 0 0 0 0 0 0 0 681 673 657 0 0 0 673 673 665 653 0 0 0 652 667 714 713 673 674 665 653 0 0 0 681 682
0 0 0 0 0 0 0 0 1145 1145 1145 1145 1145 1145 1145 0 0 0 0 0 0 0 0 0 0 0 0 0 0 0 0 0 0 0 0 673 657 0 0 0 681 673 673 665 653 652 666 667 714 714 721 673 715 673 665 653 0 0 0 0
0 0 0 0 0 0 0 0 1153 1153 1153 1153 1153 1153 1153 1463 1464 0 0 0 0 0 0 0 0 0 0 0 0 0 0 0 0 0 0 681 657 0 0 0 0 681 673 673 665 667 713 675 714 722 0 681 723 673 673 657 0 0 0 0
0 0 0 0 0 0 0 0 1153 1153 1153 1153 1153 1153 1153 1471 1472 0 0 0 0 0 0 0 0 0 0 0 0 0 0 0 0 0 0 0 657 0 0 0 0 0 681 673 673 675 713 675 722 0 0 0 0 681 673 665 653 0 0 0
0 0 0 0 0 0 0 0 1161 1161 1161 1161 1161 1161 1161 1479 1480 0 0 0 0 0 0 0 0 0 0 0 0 0 0 0 0 0 0 0 665 653 0 0 0 0 0 681 673 675 721 683 0 0 0 0 0 0 681 673 665 653 0 0
0 0 0 0 0 0 0 0 929 930 930 930 930 936 931 1443 0 0 0 0 0 0 0 0 0 0 0 0 0 0 0 0 0 0 0 0 673 665 666 653 0 0 0 0 681 683 0 0 0 0 0 0 0 0 0 673 673 665 666 666
0 0 0 0 0 0 0 0 937 938 938 938 938 944 939 1443 1444 0 0 0 0 0 0 0 0 0 0 0 0 0 0 0 0 0 0 0 673 673 674 657 0 0 0 0 0 0 0 0 0 0 0 0 0 0 0 681 673 673 674 674
0 0 0 0 0 0 0 0 1453 1454 0 0 0 0 855 856 0 0 0 0 0 0 0 0 0 0 0 0 0 0 0 0 0 0 0 0 681 673 674 665 653 0 0 0 0 0 0 0 0 0 0 0 0 0 0 0 681 673 674 674
0 0 0 0 0 803 804 0 0 0 0 0 0 0 863 864 0 0 0 0 0 0 0 0 0 0 0 0 0 0 0 0 0 0 0 0 0 681 682 673 657 0 0 0 0 0 0 0 0 0 652 666 653 0 0 0 0 681 682 682
0 0 0 0 0 0 0 0 0 0 0 0 0 0 0 0 0 0 0 0 0 0 0 0 0 0 0 0 0 0 0 0 0 0 0 0 0 0 0 673 657 0 0 652 666 666 653 0 652 666 667 713 665 666 653 0 0 0 0 0
0 0 0 0 0 0 0 0 0 0 0 0 0 805 0 0 0 0 0 0 0 0 0 0 0 0 0 0 0 0 0 0 0 0 0 0 0 0 0 681 665 653 0 659 713 674 665 0 667 713 675 713 673 674 665 653 0 0 0 0
0 0 0 0 0 0 0 0 0 0 0 0 0 0 0 0 0 0 0 0 0 0 0 0 0 0 0 0 0 0 0 0 0 0 0 0 0 0 0 0 673 665 666 667 713 674 673 687 714 713 675 721 673 674 673 657 0 0 0 0
0 0 0 0 0 0 0 0 0 0 0 0 0 0 0 0 0 0 0 0 0 0 0 0 0 0 0 0 0 0 0 0 0 0 0 0 1138 1138 1138 1138 1138 673 674 675 721 682 673 672 714 721 683 0 681 682 673 665 0 653 0 0
0 0 0 0 0 0 0 0 0 0 0 0 0 0 0 0 0 0 0 0 0 0 0 0 0 0 0 0 0 0 0 0 0 0 0 0 1138 1138 1138 1138 1138 673 674 675 0 0 681 672 722 0 0 0 0 0 681 673 674 665 653 0
0 0 0 0 0 0 0 0 0 0 0 0 0 0 0 0 0 0 0 0 0 0 0 0 0 0 0 0 1138 1138 1138 1138 1138 1138 1138 1138 1146 1146 1146 1146 1146 681 682 683 1484 0 0 680 0 0 0 0 0 0 0 673 674 673 665 666
0 0 0 0 0 0 0 0 0 0 0 0 0 0 0 0 0 0 0 0 0 0 0 0 0 0 0 0 1138 1138 1138 1138 1138 1138 1138 1138 1154 1154 1154 1154 1154 0 0 0 1492 0 0 0 0 0 0 0 0 0 0 681 682 673 673 674
0 0 0 0 0 0 844 845 846 0 0 0 0 0 0 0 0 0 0 0 0 0 0 0 0 0 0 0 1146 1146 1146 1146 1146 1146 1146 1146 1154 1154 1154 1154 1154 0 0 0 0 0 0 0 0 0 0 0 0 0 0 0 0 681 673 674
0 0 0 0 0 0 852 853 854 0 0 0 0 0 0 0 0 0 0 0 0 0 0 0 0 0 0 0 1154 1154 1154 1154 1154 1154 1154 1154 1154 1154 1154 1154 1154 0 0 0 0 0 0 0 0 0 0 0 0 0 0 0 0 0 681 682
0 0 0 0 0 0 852 853 854 0 0 0 0 0 0 0 0 0 0 0 0 0 0 0 0 0 0 0 1154 1154 1154 1154 1154 1154 1154 1154 1162 1162 1162 1162 1162 1463 1464 0 0 0 0 0 0 0 0 0 0 0 0 0 0 0 0 0
0 0 0 0 0 0 852 853 854 0 0 0 0 0 0 0 0 0 0 0 0 0 0 0 0 0 0 0 1154 1154 1154 1154 1154 1154 1154 1154 962 962 962 962 963 1471 1472 0 0 0 0 0 0 0 0 0 0 0 0 0 0 0 0 0
0 0 0 0 0 0 860 861 862 0 0 0 0 0 0 0 0 0 0 0 0 0 0 0 0 0 0 0 1162 1162 1162 1162 1162 1162 1162 1162 962 962 962 962 963 1479 1480 0 0 0 0 0 0 0 0 0 0 0 0 0 0 0 0 0
0 0 0 0 0 0 0 0 0 0 0 0 0 0 0 0 0 0 0 0 0 0 0 0 0 0 0 0 961 962 968 962 962 962 962 962 962 962 968 962 963 1452 1434 0 0 0 0 0 0 0 0 0 0 0 0 0 0 0 0 0
0 1518 1438 1301 1285 1518 0 0 0 0 0 807 808 0 0 0 0 0 0 0 0 0 0 0 0 0 0 0 969 970 976 970 970 970 970 970 970 970 976 970 971 1452 0 0 0 0 0 0 0 0 0 0 0 0 0 0 0 0 0 0
1606 1526 1250 1251 1252 1526 813 0 0 0 0 815 816 0 0 1500 0 0 0 0 0 0 0 0 0 0 0 0 0 0 0 0 0 1437 1433 1433 0 0 0 0 0 0 0 0 0 0 0 0 0 0 0 0 0 0 0 0 0 0 0 0
1414 1415 1416 0 0 0 0 0 0 0 0 0 0 0 0 1508 0 0 0 0 0 0 0 1484 0 0 806 0 0 0 0 0 0 0 0 0 0 0 0 0 0 0 0 0 0 0 0 0 0 0 0 0 0 0 0 0 0 0 0 0
1430 1431 1432 0 0 0 0 0 0 0 0 0 0 0 0 0 0 0 0 0 0 0 0 1492 0 0 814 0 0 0 0 0 0 0 0 0 0 0 0 0 0 0 0 0 0 0 0 0 0 0 0 0 0 0 0 0 0 0 0 0
0 0 0 0 0 0 0 0 0 0 0 0 0 0 0 0 0 0 841 842 842 842 842 843 0 0 0 0 0 0 0 0 0 0 0 0 0 0 0 0 0 0 0 0 0 0 0 0 0 0 0 0 0 0 0 0 0 0 0 0
0 0 0 0 0 0 0 0 0 0 0 0 0 0 0 0 0 0 849 850 850 850 850 851 0 0 0 0 0 0 0 0 0 0 0 0 0 0 0 0 0 0 0 0 0 0 0 0 0 0 0 0 0 0 0 0 0 0 0 0
0 0 0 0 0 0 0 0 0 0 0 0 0 0 0 0 0 1484 857 858 858 858 858 859 0 0 0 1139 1139 1139 1139 1139 1139 1139 0 0 0 0 0 0 0 0 0 0 0 0 0 0 0 0 0 0 0 0 0 0 0 0 0 0
0 0 0 0 0 0 0 0 0 0 0 0 0 0 0 0 0 1492 0 0 0 0 0 0 0 0 0 1147 1147 1147 1147 1147 1147 1147 1461 1462 0 0 0 0 0 0 0 0 0 0 0 0 0 0 0 0 0 0 0 0 0 0 0 0
0 0 0 0 0 0 0 0 0 0 0 0 0 0 0 0 0 0 0 0 0 0 0 0 0 0 0 1155 1155 1155 1155 1155 1155 1155 1469 1470 0 0 0 0 0 0 0 0 0 0 0 0 0 0 0 0 0 0 0 0 0 0 0 0
0 0 0 0 0 0 0 0 0 0 0 0 0 0 0 0 0 0 0 0 0 0 0 0 0 0 1434 1155 1155 1155 1155 1155 1155 1155 1477 1478 0 0 0 0 0 0 0 0 0 0 0 0 0 0 0 0 0 0 0 0 0 0 0 0
0 0 0 0 0 0 0 0 0 0 0 0 0 0 0 0 0 0 0 0 0 0 0 0 0 0 1434 1163 1163 1163 1163 1163 1163 1163 0 0 0 0 0 0 0 0 0 0 0 0 0 0 0 0 1484 0 0 0 0 1484 0 0 0 0
0 0 0 0 0 0 0 0 0 0 0 0 0 0 0 0 0 0 0 0 0 0 0 0 0 0 0 993 994 994 994 994 994 995 0 0 0 0 0 0 0 0 0 0 0 0 0 0 0 0 1492 0 0 0 0 1492 0 0 0 0
0 0 0 0 0 0 0 0 0 0 0 0 0 0 0 0 0 0 0 0 0 0 0 0 0 0 0 1001 1002 1002 1002 1002 1002 1003 0 0 0 0 0 0 0 1023 1023 1023 1023 1023 1023 1023 1023 1023 1023 1023 0 0 1023 1141 1141 1141 1141 1141
0 0 0 0 0 0 0 0 0 0 0 0 0 0 0 0 0 0 0 0 0 0 0 0 0 0 0 0 0 0 0 0 0 0 0 0 0 0 0 1023 1023 1023 1013 1010 1010 1010 1010 1010 1010 1010 1010 1011 0 0 1009 1149 1149 1149 1149 1149
0 0 0 0 0 0 0 0 0 0 0 0 0 0 0 0 0 0 0 0 0 0 0 0 0 0 0 0 0 0 0 0 0 0 0 0 0 0 1023 1023 1013 1011 1013 1010 1141 1141 1141 1141 1141 1141 1010 1011 1217 1218 1009 1157 1157 1157 1157 1157
0 0 0 0 0 0 0 0 0 0 0 0 0 0 0 0 0 0 0 0 0 0 0 0 0 0 0 0 0 0 0 0 0 0 0 0 1023 1023 1023 1014 1013 1011 1021 1018 1149 1149 1149 1149 1149 1149 1018 1019 1225 1226 1017 1165 1165 1165 1165 1165
0 0 0 0 0 0 0 0 0 0 0 0 0 0 0 0 0 0 0 0 0 0 0 0 0 0 0 0 0 0 0 0 0 0 0 1023 1023 1013 1011 1014 1021 1019 1463 1464 1157 1157 1157 1157 1157 1157 0 0 0 0 0 1165 1165 1165 1165 1165
0 0 0 0 0 0 0 0 0 0 0 0 0 0 0 0 0 0 0 0 0 0 0 0 0 0 0 0 0 0 0 0 0 0 0 1023 1014 1013 1011 1022 0 0 1471 1472 1165 1165 1165 1165 1165 1165 0 0 0 0 0 1009 1010 1010 1010 1010
0 0 0 0 0 0 0 0 0 0 0 0 0 0 0 0 0 0 0 644 1637 0 0 0 0 0 0 0 0 0 0 0 0 0 0 1023 1014 1021 1019 0 0 0 1479 1480 1165 1165 1165 1165 1165 1165 0 0 0 0 0 1009 1010 1010 1010 1010
0 0 0 0 0 0 0 0 0 0 0 0 0 0 0 0 0 0 0 0 0 0 0 0 0 0 0 0 0 0 0 0 0 0 1023 1023 1022 0 0 0 0 0 0 0 1009 1010 1010 1010 1016 1011 0 0 0 0 1452 1009 1010 1016 1010 1010
0 0 0 0 0 0 0 0 0 0 0 0 0 0 0 0 0 0 0 0 0 0 0 0 0 0 0 0 0 0 0 0 0 0 1023 1014 0 0 0 0 0 0 0 0 1017 1018 1018 1018 1024 1019 0 0 0 0 1452 1017 1018 1024 1018 1018
0 0 0 0 0 0 0 0 0 0 0 0 0 0 0 0 0 0 0 0 0 0 0 0 0 0 0 0 0 0 0 0 0 0 1023 1141 1141 1141 1141 1141 0 0 0 0 0 0 0 0 0 0 0 0 0 0 0 0 0 0 1433 1433
0 0 0 0 0 0 0 0 0 0 0 0 0 0 0 0 0 0 0 0 0 0 0 0 0 0 0 0 0 0 0 0 0 0 1023 1149 1149 1149 1149 1149 0 0 868 868 868 868 868 868 868 868 868 868 0 0 0 868 868 868 868 868
0 0 0 0 0 0 0 0 0 0 0 0 0 0 0 0 0 0 0 0 0 0 0 0 0 0 0 0 0 0 0 0 0 0 1023 1157 1157 1157 1157 1157 0 0 868 0 0 0 0 0 0 0 0 0 826 825 828 0 0 0 0 0
0 0 0 0 0 0 0 0 0 0 0 0 0 0 0 0 0 0 0 0 0 0 0 0 0 0 0 0 0 0 0 0 0 0 1023 1165 1165 1165 1165 1165 0 0 868 0 0 0 0 0 0 0 0 0 826 825 828 0 0 0 0 0
0 0 0 0 0 0 0 0 0 0 0 0 0 0 0 0 0 0 0 0 0 0 0 0 0 0 0 0 0 0 0 0 0 0 1023 1165 1165 1165 1165 1165 0 0 868 0 0 0 0 0 0 0 0 0 826 825 828 0 0 0 0 0
0 0 0 0 0 0 0 0 0 0 0 0 0 0 0 0 0 0 0 0 0 0 0 0 0 0 0 0 0 0 0 0 0 0 1023 1009 1010 1010 1010 1011 0 0 868 0 0 0 0 0 0 0 0 0 834 825 836 0 0 0 0 0
0 0 0 0 0 0 0 0 0 0 0 0 0 0 0 0 0 0 0 0 0 0 0 0 0 0 0 0 0 0 0 0 0 0 1023 1017 1018 1018 1018 1019 0 0 868 0 0 0 0 868 868 868 868 868 0 0 0 868 868 868 868 868
0 0 0 0 0 0 0 0 0 0 0 0 0 0 0 0 0 0 0 0 0 0 0 0 0 0 0 0 0 0 0 0 0 0 1023 0 0 0 0 0 0 0 868 0 0 0 0 868 0 0 0 0 0 0 0 0 0 0 0 0
0 0 0 0 0 0 0 0 0 0 0 0 0 0 0 0 0 0 0 0 0 0 0 0 0 0 0 0 0 0 0 0 0 0 1023 1141 1141 1141 1141 1141 0 0 868 0 0 0 0 868 0 0 1520 0 0 0 0 0 1520 0 0 0
0 0 0 0 0 0 0 0 0 0 0 0 0 0 0 0 0 0 0 0 0 0 0 0 0 0 0 0 0 0 0 0 0 0 1023 1149 1149 1149 1149 1149 0 0 0 817 817 817 817 0 0 0 0 0 1505 1506 1507 0 0 0 0 0
0 0 0 0 0 0 0 0 0 0 0 0 0 0 0 0 0 0 0 0 0 0 0 0 0 0 0 0 0 0 0 0 0 0 1023 1157 1157 1157 1157 1157 0 0 0 825 825 825 825 0 0 0 0 0 1513 1514 1515 0 0 0 0 0
0 0 0 0 0 0 0 0 0 0 0 0 0 0 0 0 0 0 0 0 0 0 0 0 0 0 0 0 0 0 0 0 0 0 1023 1165 1165 1165 1165 1165 0 0 868 833 833 833 833 868 0 0 0 0 1521 1522 1523 0 0 0 0 0
0 0 0 0 0 0 0 0 0 0 0 0 0 0 0 0 0 0 0 0 0 0 0 0 0 0 0 0 0 0 0 0 0 0 1023 1165 1165 1165 1165 1165 0 0 868 818 819 819 820 868 0 0 1520 0 0 0 0 0 1520 0 0 0
0 0 0 0 0 0 0 0 0 0 0 0 0 0 0 0 0 0 0 0 0 0 0 0 0 0 0 0 0 0 0 0 0 0 1023 1009 1010 1010 1010 1011 0 0 868 0 0 0 0 868 0 0 0 0 0 0 0 0 0 0 0 0
