577 577 577 577 577 577 577 577 577 577 577 577 577 577 577 577 577 577 577 577 577 577 577 577 577 577 577 577 577 1943 1944 577 577 577 577 577 577 577 577 577 577 577 1710 1718 582 582 582 1717 1711 1711 1711 1711 1718 582 582 582 582 582 582 582
577 577 577 577 577 577 577 577 577 577 577 577 577 577 577 577 577 577 577 577 577 577 577 577 577 577 577 577 1943 1943 1944 577 577 577 577 577 577 577 577 577 577 577 577 1710 1718 1717 1711 1712 577 577 577 577 1710 1711 1718 582 582 582 582 582
577 577 577 577 577 577 577 577 577 577 577 577 577 577 577 577 577 577 577 577 577 577 577 577 577 577 577 577 1943 1943 1944 577 577 577 577 577 577 577 577 577 577 577 577 577 1710 1712 577 577 577 577 577 577 577 1710 1710 1718 582 582 582 582
577 577 577 577 577 577 577 577 577 577 577 577 577 577 577 577 577 577 577 577 577 577 577 577 577 577 577 577 1943 1943 1944 577 577 577 577 577 577 577 577 577 577 577 577 577 577 577 577 577 577 577 577 577 577 577 1710 1710 1718 582 582 582
577 577 577 577 577 577 577 577 577 577 577 577 577 577 577 577 577 577 577 577 577 577 577 577 577 577 577 577 1943 1943 1965 1936 577 577 577 577 577 577 577 577 577 577 577 577 577 577 577 577 577 577 582 582 577 577 577 577 1710 1718 582 1717
577 577 577 577 577 577 577 577 577 577 577 577 577 577 577 577 577 577 577 577 577 577 577 577 577 577 577 1943 1943 1943 1943 1944 577 577 577 577 577 577 577 577 577 577 577 577 577 577 577 577 577 577 1710 1718 582 577 577 577 577 1702 582 1712
577 577 577 577 577 577 577 577 577 577 577 577 577 577 577 577 577 577 577 577 577 577 577 577 577 577 577 1943 1943 1943 1943 1965 1936 577 577 577 577 577 577 577 577 577 577 577 577 577 577 577 577 577 577 1710 1711 1718 577 577 577 1710 1714 577
577 577 577 577 577 577 577 577 577 577 577 577 577 577 577 577 577 577 577 577 577 577 577 577 577 577 1943 1943 1943 1943 1943 1943 1965 1936 577 577 577 577 577 577 577 577 577 577 577 577 577 577 577 577 577 577 577 1710 577 577 577 577 1709 577
577 577 577 577 577 577 577 577 577 577 577 577 577 577 577 577 577 577 577 577 577 577 577 577 577 577 1943 1943 1943 1943 1943 1943 1943 1944 577 577 577 577 577 577 577 577 577 577 577 577 577 577 577 577 577 577 577 577 577 577 577 577 577 577
577 577 577 577 577 577 577 577 577 577 577 577 1655 1655 1655 577 577 577 577 577 577 577 577 577 577 1943 1943 1943 1943 1943 1943 1943 1957 1952 577 577 577 577 577 577 577 577 577 577 577 577 577 577 577 577 577 577 577 577 577 577 577 577 577 577
577 577 577 577 577 577 577 577 577 577 577 1654 1655 1669 1664 577 577 577 577 577 577 577 577 577 577 1943 1943 1943 1943 1943 1957 1951 1952 577 577 577 577 577 577 577 577 577 577 577 577 577 577 577 577 577 577 577 577 577 577 577 577 577 577 577
577 577 577 577 577 577 577 577 577 577 1646 1678 1655 1656 577 577 577 577 577 577 577 577 577 577 1943 1943 1943 1943 1943 1957 1952 577 577 577 577 577 577 577 577 577 577 577 577 577 577 577 577 577 577 577 577 577 577 577 577 577 577 577 577 577
577 577 577 577 577 577 577 577 577 1646 1678 1655 1669 1664 577 577 577 577 577 577 577 577 577 577 1943 1943 1943 1943 1957 1952 577 577 577 577 577 577 577 577 577 577 577 577 577 577 577 577 577 577 577 577 577 577 577 577 577 577 577 577 577 577
577 577 577 577 577 577 577 577 1646 1678 1669 1663 1664 577 577 577 577 577 577 577 577 577 577 577 1943 1943 1943 1943 1944 577 577 577 577 577 577 577 577 577 577 577 577 577 577 577 577 577 577 577 577 577 577 577 577 577 577 577 577 577 577 577
577 577 577 577 577 577 577 1646 1678 1669 1664 577 577 577 577 577 577 577 577 577 577 577 577 1943 1943 1943 1943 1957 1952 577 577 577 577 577 577 577 577 577 577 577 577 577 577 577 577 577 577 577 577 577 577 577 577 577 577 577 577 577 577 577
577 577 577 577 577 577 577 1654 1655 1656 577 577 577 577 577 577 577 577 577 577 577 577 1943 1943 1943 1943 1957 1952 577 577 577 577 577 577 577 577 577 577 577 577 577 577 577 577 577 577 577 577 577 577 577 577 577 578 578 577 577 577 577 577
577 577 577 577 577 577 1646 1678 1669 1664 577 577 577 577 577 577 577 577 577 577 577 577 1943 1943 1943 1943 1944 577 577 577 577 577 577 577 577 577 577 577 577 577 577 577 577 577 577 577 577 577 577 577 577 577 1838 1870 578 577 577 577 577 577
577 577 577 577 577 577 1654 1655 1656 577 577 577 577 577 577 577 577 577 577 577 577 577 1943 1838 1958 1957 1952 577 577 577 577 577 577 577 577 577 577 577 577 577 577 577 577 577 577 577 577 577 577 577 577 1838 1870 578 578 578 578 577 577 577
577 577 577 577 577 577 1654 1655 1656 577 577 577 577 577 577 577 577 577 577 577 577 577 577 577 1953 1952 577 577 577 577 577 577 577 577 577 577 577 577 577 577 577 577 577 577 577 577 577 577 577 577 577 1846 578 578 578 578 578 578 577 577
577 577 577 577 577 577 1654 1655 1656 577 577 577 577 577 577 577 577 577 577 577 577 577 577 1930 1946 577 577 577 577 577 577 577 577 577 577 577 577 577 577 577 577 577 577 577 577 577 577 577 577 577 1838 1870 578 578 578 578 578 578 578 578
577 577 577 577 577 577 577 577 577 577 577 577 577 577 577 577 577 577 577 577 577 577 577 577 577 577 577 577 577 577 577 577 577 577 577 577 577 577 577 577 577 577 577 577 577 577 577 577 577 1838 1870 578 578 578 578 578 578 578 578 578
577 577 577 577 577 577 577 577 577 577 577 577 577 577 577 577 577 577 577 577 577 577 577 577 577 577 577 577 577 577 577 577 577 577 577 577 577 577 577 577 577 577 577 577 577 577 577 577 577 1854 1855 1862 578 578 578 578 578 578 578 578
577 577 577 577 577 577 577 577 577 577 577 577 577 577 577 577 577 577 577 577 577 577 577 577 577 577 577 577 577 577 577 577 577 577 577 577 577 577 577 577 577 577 577 577 577 577 577 577 577 577 577 1854 1855 1862 578 578 578 578 578 578
577 577 577 577 577 577 1654 1655 1656 577 577 577 577 577 577 577 577 577 577 577 577 577 577 577 577 577 577 577 577 577 577 577 577 577 577 577 577 577 577 577 577 577 577 577 577 577 577 577 577 577 577 577 577 1854 1862 578 578 578 578 578
577 577 577 577 577 577 1654 1655 1677 1648 577 577 577 577 577 577 577 577 577 577 577 577 577 577 577 577 577 577 577 577 577 577 577 577 577 577 577 577 577 577 577 577 577 577 577 577 577 1834 1840 577 577 577 577 577 1846 578 578 578 578 578
577 577 577 577 577 577 1662 1670 1655 1677 1648 577 577 577 577 577 577 577 577 577 577 577 577 577 577 577 577 577 577 577 1670 1669 577 577 577 577 577 581 581 581 577 577 577 577 577 577 577 577 1853 577 577 577 577 577 1854 1855 1855 1862 578 578
577 577 577 577 577 577 577 1654 1655 1655 1656 577 577 577 577 577 577 577 577 577 577 577 577 577 577 577 577 577 577 577 1654 1656 577 577 577 577 577 1654 581 1656 577 577 577 577 577 577 577 577 577 1833 1838 1839 1840 577 577 577 1833 1846 578 578
577 577 577 577 577 577 577 1662 1670 1655 1677 1647 1647 1648 577 577 577 577 577 577 577 577 577 577 577 577 577 577 577 1646 1678 1677 1648 577 577 577 577 1654 581 1656 577 577 577 577 577 577 577 577 577 1834 1876 578 1869 1840 577 577 577 1846 578 578
577 577 577 577 577 577 577 577 1662 1670 1655 1655 1655 1677 1647 1647 1648 577 577 577 577 577 577 577 577 577 577 1646 1647 1678 581 581 1677 1647 1647 1647 1647 1678 581 1677 1648 577 577 577 577 577 577 577 577 577 1854 1855 1862 1875 1836 577 1838 1870 578 578
577 577 577 577 577 577 577 577 577 1662 1670 1655 1655 1655 1655 1655 1677 1647 1648 577 577 577 581 1646 1647 1647 1647 1678 581 581 581 581 581 581 581 581 581 581 581 581 1656 577 577 577 577 577 577 577 577 577 577 577 1854 1856 577 577 1846 578 578 578
577 577 577 577 577 577 577 577 577 577 1654 1655 1655 1655 1655 1655 1655 1655 1655 577 577 577 581 581 581 581 581 581 581 581 581 581 581 581 581 581 581 581 581 581 1677 1648 577 577 577 577 577 577 577 577 577 577 577 577 577 577 1854 1855 1862 578
577 577 577 577 577 577 577 577 577 577 1662 1670 1655 1669 1663 1663 1663 1663 1663 577 577 577 581 581 581 581 581 1669 1663 1663 1663 1663 1663 1663 1670 581 581 581 581 581 581 1677 1647 1648 577 577 577 577 577 577 577 577 577 577 577 577 577 577 1854 1855
577 577 577 577 577 577 577 577 577 577 577 1662 1663 1664 577 577 577 577 577 577 577 577 1662 1663 1663 1663 1663 1664 577 577 577 577 577 577 1662 1663 1663 1663 1670 581 581 581 581 1677 1647 1647 1648 577 577 577 577 577 577 577 577 577 577 577 577 577
577 577 577 577 577 577 577 577 577 577 577 577 577 577 577 577 577 577 577 577 577 577 577 577 577 577 577 577 577 577 577 577 577 577 577 577 577 577 1662 1663 1663 1663 1670 581 581 581 1677 1647 1647 1647 1647 1647 1648 577 577 577 577 577 577 577
577 577 577 577 577 577 577 577 577 577 577 577 577 577 577 577 577 577 577 577 577 577 577 577 577 577 577 577 577 577 577 577 577 577 577 577 577 577 577 577 577 577 1662 1670 581 581 581 581 581 581 581 581 1677 1648 577 577 577 577 577 577
577 577 577 577 577 577 577 577 577 577 577 577 577 577 577 577 577 577 577 577 577 577 577 577 577 577 577 577 577 577 577 577 577 577 577 577 577 577 577 577 577 577 577 1662 1663 1663 1663 1663 1670 581 581 581 581 1656 577 577 577 577 577 577
577 577 577 577 577 577 577 577 577 577 577 577 577 577 577 577 577 577 577 577 577 577 577 577 577 577 577 577 577 577 577 577 577 577 577 577 577 577 577 577 577 577 577 577 577 577 577 577 1662 1663 1670 581 581 1656 577 577 577 577 577 577
577 577 577 577 577 577 577 577 577 577 577 577 577 577 577 577 577 577 577 577 577 577 577 577 577 577 577 577 577 577 577 577 577 577 577 577 577 577 577 577 577 577 577 577 577 577 577 577 577 577 577 577 581 1677 577 577 577 577 577 577
577 577 577 577 577 577 577 577 577 577 577 577 577 577 577 577 577 577 577 577 577 577 577 577 577 577 577 577 577 577 577 577 577 577 577 577 577 577 577 577 577 577 577 577 577 577 577 577 577 577 577 577 581 581 577 577 577 577 577 577
577 577 577 577 577 577 577 577 577 577 577 577 577 577 577 577 577 577 577 577 577 577 577 577 577 577 577 577 577 577 577 577 577 577 577 577 577 577 577 577 577 577 577 577 577 577 577 577 577 577 577 577 581 581 577 577 577 577 577 577
577 577 577 577 577 577 577 577 577 577 577 577 577 577 577 577 577 577 577 577 577 577 577 577 577 577 577 577 577 577 577 577 577 577 577 577 577 577 577 577 577 577 577 577 577 577 577 577 577 577 867 867 867 867 577 577 577 577 577 577
577 577 577 577 577 577 577 577 577 577 577 577 577 577 577 577 577 577 577 577 577 577 577 577 577 577 577 577 577 577 577 577 577 577 577 577 577 577 577 577 577 577 867 867 867 867 867 867 867 867 867 867 867 867 867 867 867 867 867 867
577 577 577 577 577 577 577 577 577 577 577 577 577 577 577 577 577 577 577 577 577 577 577 577 577 577 577 577 577 577 577 577 577 577 577 577 577 577 577 577 867 867 867 867 867 867 867 867 867 867 867 867 867 867 867 867 867 867 867 867
577 577 577 577 577 577 577 577 577 577 577 577 577 577 577 577 577 577 577 577 577 577 577 577 577 577 577 577 577 577 577 577 577 577 577 577 577 577 577 867 867 867 867 867 867 867 867 867 867 867 867 867 867 867 867 867 867 867 867 867
1792 577 577 577 577 577 577 577 577 577 577 577 577 577 577 577 577 577 577 577 577 577 577 577 577 577 577 577 577 577 577 577 577 577 577 577 577 867 867 867 867 867 867 867 867 867 867 867 867 867 867 867 867 867 867 867 867 867 867 867
1800 577 577 577 577 577 577 577 577 577 577 577 577 577 577 577 577 577 577 577 577 577 577 577 577 577 577 577 577 577 577 577 577 577 577 577 867 867 867 867 867 867 867 867 867 867 867 867 867 867 867 867 867 867 867 867 867 867 867 867
1800 577 577 577 577 577 577 577 577 577 577 577 577 577 577 577 577 577 577 577 577 577 577 577 577 577 577 577 577 577 577 577 577 577 577 577 867 867 867 867 867 867 867 867 867 867 867 867 867 867 867 867 867 867 867 867 867 867 867 867
1821 1792 577 577 577 577 577 577 577 577 577 577 577 577 577 577 577 577 577 577 577 577 577 577 577 577 577 577 577 577 577 577 577 577 577 577 867 867 867 867 867 867 867 867 867 867 867 867 867 867 867 867 867 867 867 867 867 867 867 867
584 1800 577 577 577 577 577 577 577 577 577 577 577 577 577 577 577 577 577 577 577 577 577 577 577 577 577 577 577 577 577 577 577 577 577 867 867 867 867 867 867 867 867 835 835 835 835 835 835 835 835 835 835 835 835 835 835 835 835 835
584 1821 1792 577 577 577 577 577 577 577 577 577 577 577 577 577 577 577 577 577 577 577 577 577 577 577 577 577 577 577 577 577 577 577 577 867 867 867 867 867 867 867 867 835 835 835 835 835 835 835 835 835 835 835 835 835 835 835 835 835
584 584 1821 1792 577 577 577 577 577 577 577 577 577 577 577 577 577 577 577 577 577 577 577 577 577 577 577 577 577 577 577 577 577 577 577 867 867 867 867 867 867 867 867 867 867 867 867 867 867 867 867 867 867 867 867 867 867 867 867 867
584 584 584 1821 1792 577 577 577 577 577 577 577 577 577 577 577 577 577 577 577 577 577 577 577 577 577 577 577 577 577 577 577 577 577 577 867 867 867 867 867 867 867 867 867 867 867 867 867 867 867 867 867 867 867 867 867 867 867 867 867
584 584 584 584 1821 1791 1791 1792 577 577 577 577 577 577 577 577 577 577 577 577 577 577 577 577 577 577 577 577 577 577 577 577 577 577 577 867 867 867 867 867 867 867 867 867 867 867 867 867 867 867 867 867 867 867 867 867 867 867 867 867
584 584 584 584 584 584 584 1821 1791 584 577 577 577 577 577 577 1792 577 577 577 577 577 577 577 577 577 577 577 577 577 577 577 577 577 577 867 867 867 867 867 867 867 867 867 867 867 867 867 867 867 867 867 867 867 867 867 867 867 867 867
584 584 584 584 584 584 584 584 584 584 584 584 584 577 577 584 1800 577 577 577 577 577 577 577 577 577 577 577 577 577 577 577 577 577 577 867 867 867 867 867 867 867 867 867 867 867 867 867 867 867 884 884 884 884 884 884 884 867 867 867
584 584 584 584 584 584 584 584 584 584 584 584 584 584 584 584 1800 577 577 577 577 577 577 577 577 577 577 577 577 577 577 577 577 577 577 867 867 867 867 867 867 867 867 867 867 867 867 867 867 867 884 884 884 884 884 884 884 867 867 867
584 584 584 584 584 584 584 584 584 584 584 584 584 584 584 584 1821 1792 577 577 577 577 577 577 577 577 577 577 577 577 577 577 577 577 577 867 867 867 867 867 867 867 867 867 867 867 867 867 867 867 884 884 884 884 884 884 884 867 867 867
584 584 584 584 584 584 584 584 584 584 584 584 584 584 584 584 584 1821 1791 1792 577 577 577 577 577 577 577 577 577 577 577 577 577 577 577 867 867 867 867 867 867 867 867 867 867 867 867 867 867 867 884 884 884 884 884 884 884 867 867 867
584 584 584 584 584 584 584 584 584 584 584 584 577 577 584 584 584 584 584 1821 1791 1792 577 577 577 577 577 577 577 577 577 577 577 577 577 867 867 867 867 867 867 867 867 867 867 867 867 867 867 867 884 884 884 884 884 884 884 867 867 867
584 584 584 584 584 584 584 584 584 584 584 584 584 584 584 584 584 584 584 584 584 1821 1792 577 577 577 577 577 577 577 577 577 577 577 577 867 867 867 867 867 867 867 867 867 867 867 867 867 867 867 867 867 867 867 867 867 867 867 867 867
